The — el/la/los/las.
Be — ser/estar.
To — a/para/hasta…
Of — de.
And — y.
A — una/una.
In — en/dentro de.
That — ese/esa.
Have — tener (también funciona como verbo auxiliar).
I — yo.
It — él/ella (versión neutra).
For — para/durante.
Not — no.
On — encima de/encendido.
With — con.
He — él.
As — como/ya que.
You — tú.
Do — hacer (también funciona como verbo auxiliar).
At — en/a las.
45 
456
  そら, あ.く, あ.き, あ.ける, から, す.く, す.かす, むな.しい
田	campo de arroz	た
天	paraíso	あま
生	vida	い.きる, う.む, なま
@
=
+
#
^